TAA	*	Ter	Stop_Codon
TAG	*	Ter	Stop_Codon
TGA	*	Ter	Stop_Codon
GCA	A	Ala	Alanine
GCC	A	Ala	Alanine
GCG	A	Ala	Alanine
GCT	A	Ala	Alanine
TGC	C	Cys	Cysteine
TGT	C	Cys	Cysteine
GAC	D	Asp	Aspartic_Acid
GAT	D	Asp	Aspartic_Acid
GAA	E	Glu	Glutamic_Acid
GAG	E	Glu	Glutamic_Acid	
TTC	F	Phe	Phenylalanine
TTT	F	Phe	Phenylalanine
GGA	G	Gly	Glycine
GGC	G	Gly	Glycine
GGG	G	Gly	Glycine
GGT	G	Gly	Glycine
CAC	H	His	Histidine
CAT	H	His	Histidine
ATA	I	Ile	Isoleucine
ATC	I	Ile	Isoleucine
ATT	I	Ile	Isoleucine
AAA	K	Lys	Lysine
AAG	K	Lys	Lysine
CTA	L	Leu	Leucine
CTC	L	Leu	Leucine
CTG	L	Leu	Leucine
CTT	L	Leu	Leucine
TTA	L	Leu	Leucine
TTG	L	Leu	Leucine
ATG	M	Met	Methionine
AAC	N	Asn	Asparagine
AAT	N	Asn	Asparagine
CCA	P	Pro	Proline
CCC	P	Pro	Proline
CCG	P	Pro	Proline
CCT	P	Pro	Proline
CAA	Q	Gln	Glutamine
CAG	Q	Gln	Glutamine
AGA	R	Arg	Arginine
AGG	R	Arg	Arginine															
CGA	R	Arg	Arginine
CGC	R	Arg	Arginine
CGG	R	Arg	Arginine
CGT	R	Arg	Arginine
AGC	S	Ser	Serine
AGT	S	Ser	Serine
TCA	S	Ser	Serine
TCC	S	Ser	Serine
TCG	S	Ser	Serine
TCT	S	Ser	Serine
ACA	T	Thr	Threonine
ACC	T	Thr	Threonine
ACG	T	Thr	Threonine
ACT	T	Thr	Threonine
GTA	V	Val	Valine
GTC	V	Val	Valine
GTG	V	Val	Valine
GTT	V	Val	Valine
TGG	W	Trp	Tryptophan
TAC	Y	Tyr	Tyrosine
TAT	Y	Tyr	Tyrosine
